#######
#..P..#
#.....#
#.....#
#.....#
#..N..#
#######
